Your friends decided to play a fun game of hide and seek, but there is a twist! The game will take place in the dark and to find people you need to see them with your flashlight. Everyone starts in the basement! You are the seeker and you need to find everyone. (*MAKE SURE WHEN YOU FIND THEM, YOU TAKE THEM WITH YOU*) Ready? Go!

HideNSeek
An Interactive Fiction by lindsay palsgrove
Release 1 / Serial number 140915 / Inform 7 build 6L02 (I6/v6.33 lib 6/12N) SD

Basement
It doesn't seem like anyone is hiding in the basement, so let's go somewhere else! There is the bathroom south, the living room west and the kitchen east of the basement

>w
Living room
You sense someone in the room, there is a cabinet, table and a tv. Maybe someone is behind it?

You can see Tv and a cabinet (closed) here.

>e
Basement
Your friends decided to play a fun game of hide and seek, but there is a twist! The game will take place in the dark and to find people you need to see them with your flashlight. Ready? Go!

Everyone starts in the basement! You are the seeker and you need to find everyone. There is the bathroom south, the living room west and the kitchen east of the basement

>s
Bathroom
You see some footprints going east to the bedroom.

>e
Bedroom

>e
You can't go that way.

>e
You can't go that way.

>n
You can't go that way.

>n
You can't go that way.

* * *

>w
Living room
You sense someone in the room, there is a cabinet, table and a tv. Maybe someone is behind it?

You can see Tv and a cabinet (closed) here.

>open cabinet
You open the cabinet, revealing Rebecca.

>take rebecca
[Your score has just gone up by one point.]

>s
You can't go that way.

>e
Basement
It doesn't seem like anyone is hiding in the basement, so let's go somewhere else! There is the bathroom south, the living room west and the kitchen east of the basement

>e
Kitchen
Maybe people are outside in the Backyard north.

You can see Wooden door and Fridge (closed) here.

>open fridge
You open Fridge.

>n
(first opening Wooden door)
It seems to be locked.

>open shed
You can't see any such thing.

>take joe
You can't see any such thing.

>n\
That's not a verb I recognise.

>n
(first opening Wooden door)
It seems to be locked.

>e
You can't go that way.

>s
Bedroom
You can see Bed (in which is Blake) here.

>n
Kitchen
Maybe people are outside in the Backyard north.

You can see Wooden door and Fridge (empty) here.

>s
Bedroom
You can see Bed (in which is Blake) here.

>e
You can't go that way.

>n
Kitchen
Maybe people are outside in the Backyard north.

You can see Wooden door and Fridge (empty) here.

* * *

>s
Bedroom
You can see Bed (in which is Blake) here.

>s
You can't go that way.

>take blake
[Your score has just gone up by one point.]

>i
You are carrying:
  Blake
  Rebecca
  key

* * *

>open cabinet
You open the cabinet, revealing Rebecca.

>take Rebecca
[Your score has just gone up by one point.]

>w
You can't go that way.

>e
Basement
Your friends decided to play a fun game of hide and seek, but there is a twist! The game will take place in the dark and to find people you need to see them with your flashlight. Ready? Go!

Everyone starts in the basement! You are the seeker and you need to find everyone. There is the bathroom south, the living room west and the kitchen east of the basement

Joe follows right behind you.

* * *

>take Rebecca
[Your score has just gone up by one point.]

>n
You can't go that way.

>s
You can't go that way.

>e
Basement
Your friends decided to play a fun game of hide and seek, but there is a twist! The game will take place in the dark and to find people you need to see them with your flashlight. Ready? Go!

Everyone starts in the basement! You are the seeker and you need to find everyone. There is the bathroom south, the living room west and the kitchen east of the basement

>e
Kitchen
Maybe people are outside in the Backyard north.

You can see Wooden door and Fridge (closed) here.

* * *

>take Rebecca
[Your score has just gone up by one point.]

>e
Basement
It doesn't seem like anyone is hiding in the basement, so let's go somewhere else! There is the bathroom south, the living room west and the kitchen east of the basement

>s
Bathroom
You see some footprints going east to the bedroom. Let's go check it out!

>e
Bedroom
You can see Bed (in which is Blake) here.

* * *

>n
You can't go that way.

>e
Kitchen
There is a door going to the Backyard north.

>e
You can't go that way.

>s
Bedroom

>w
Bathroom
You see some footprints going east to the bedroom.

>n
Basement
Your friends decided to play a fun game of hide and seek, but there is a twist! The game will take place in the dark and to find people you need to see them with your flashlight. Ready? Go!

Everyone starts in the basement! You are the seeker and you need to find everyone. There is the bathroom south, the living room west and the kitchen east of the basement

>w
Living room
You sense someone in the room, there is a cabinet, table and a tv. Maybe someone is behind it?

You can see Tv and a cabinet (in which is Rebecca) here.

>e
Basement
Your friends decided to play a fun game of hide and seek, but there is a twist! The game will take place in the dark and to find people you need to see them with your flashlight. Ready? Go!

Everyone starts in the basement! You are the seeker and you need to find everyone. There is the bathroom south, the living room west and the kitchen east of the basement

>e
Kitchen

* * *

>e
Kitchen
There is a door going to the Backyard north.

>n
Wooden door

>open door
You can't see any such thing.

>open door
You can't see any such thing.

>n
Wooden door

>s
Kitchen
There is a door going to the Backyard north.

>n
Wooden door

>e
You can't go that way.

>w
You can't go that way.

>ss
That's not a verb I recognise.

>s
Kitchen
There is a door going to the Backyard north.

* * *

>n
Wooden door

>n
Wooden door

I beg your pardon?

>n
Wooden door

* * *

>open door
You can't see any such thing.

>open
What do you want to open?

>open wooden door
You can't see any such thing.

>n
Wooden door

>open
What do you want to open?

>n
You must name something more substantial.

>open door and n
You can't see any such thing.

>go north
Wooden door

>open door
You can't see any such thing.

I beg your pardon?

* * *

>s
Bathroom
This bathroon is kind of creepy! You don't think anyone is in the room. You see some footprints going east to the bedroom. Let's go check it out!

>e
Bedroom
This is your room, you know every place to hide in here! You wouldn't doubt if someone was in here.

You can see Bed, Rug and Desk here.

>n
Kitchem

>e
You can't go that way.

* * *

>n
Kitchem

>s
bedroom

* * *

>e
Bedroom
This is your room, you know every place to hide in here! You wouldn't doubt if someone was in here.

You can see Bed, Rug and Desk here.

>look under desk
Oh my gosh! Blake was under the desk the whole time :o!

>take blake
[Your score has just gone up by one point.]

>i
You are carrying:
  Blake
  key

>w
Bathroom
You see some footprints going east to the bedroom. Let's go check it out!

>s
You can't go that way.

>n
Basement
It doesn't seem like anyone is hiding in the basement, so let's go somewhere else! There is the bathroom south, the living room west and the kitchen east of the basement

>w
Living room
You sense someone in the room, there is a cabinet, table and a tv. Maybe someone is behind it?

You can see Tv and a cabinet (closed) here.

* * *

>take Rebecca
[Your score has just gone up by one point.]

>i
You are carrying:
  Rebecca
  Blake
  key

>w
You can't go that way.

>n
You can't go that way.

* * *

>e
Kitchen
Maybe people are outside in the Backyard north.

You can see Wooden door and Fridge (closed) here.

>open door
It seems to be locked.

>unlock door
What do you want to unlock Wooden door with?

>unlock door with key
You unlock Wooden door.

>n
(first opening Wooden door)

Backyard
I hear someone breathing, someone must be here! Let's find them!

You can see Wooden door, Tree and Shed (closed) here.

>open shed
You open Shed, revealing Joe.

>take joe
    *** FINALLY! YOU FOUND EVERYONE! ***

In that game you scored 3 out of a possible 3, in 22 turns.

Would you like to RESTART, RESTORE a saved game, QUIT or UNDO the last command?

* * *

>e
Bedroom
This is your room, you know every place to hide in here! You wouldn't doubt if someone was in here.

You can see Bed, Rug and Desk here.

>look in bed
You find nothing of interest.

>look in rug
You find nothing of interest.

>look in desk
You find nothing of interest.

>look under desk
Oh my gosh! Blake was under the desk the whole time :o!

* * *

>take blake
[Your score has just gone up by one point.]

>w
Bathroom
This bathroon is kind of creepy! You don't think anyone is in the room. You see some footprints going east to the bedroom. Let's go check it out!

>w
You can't go that way.

>s
You can't go that way.

* * *

>n
Basement
It doesn't seem like anyone is hiding in the basement, so let's go somewhere else! There is the bathroom south, the living room west and the kitchen east of the basement

>s
Bathroom
This bathroon is kind of creepy! You don't think anyone is in the room. You see some footprints going east to the bedroom. Let's go check it out!

>n
Basement
It doesn't seem like anyone is hiding in the basement, so let's go somewhere else! There is the bathroom south, the living room west and the kitchen east of the basement

>w
Living room
Something smells bad! Smells like body odor! EWWW! Someone has to be in here! 

You can see Tv, Couch, Lamp and Cabinet (closed) here.

>open cabinet
You open Cabinet, revealing Rebecca.

>take rebecca
[Your score has just gone up by one point.]

>w
You can't go that way.

>e
Basement
It doesn't seem like anyone is hiding in the basement, so let's go somewhere else! There is the bathroom south, the living room west and the kitchen east of the basement

>e
Kitchen
You are super hungry! D: Let's eat something. If no one is in here, there might be people outside in the backyard north.

You can see Wooden door and Fridge (closed) here.

>open fridge
You open Fridge, revealing Cookie.

>xme
That's not a verb I recognise.

>x cookie
You see nothing special about Cookie.

>what is cookie
That's not a verb I recognise.

>take cookie
Taken.

>open door
It seems to be locked.

* * *

>unlock door
What do you want to unlock Wooden door with?

>i
You are carrying:
  Cookie
  Rebecca
  Blake
  key

>unlock door with key
You unlock Wooden door.

>go in
You can't go that way.

>go trhough
You can't see any such thing.

>open door
You open Wooden door.

>go in door
Backyard
It is very chilly outside! We need to find people quick!You hear someone breathing, someone must be here! Let's find them!

You can see Wooden door, Tree and Shed (closed) here.

>look in tree
You find nothing of interest.

>look in shed
You can't see inside, since Shed is closed.

>open shed
You open Shed, revealing Joe.

>take joe
    *** FINALLY! YOU FOUND EVERYONE! Maybe next time, you'll be hiding ;) ***

In that game you scored 3 out of a possible 3, in 32 turns.

Would you like to RESTART, RESTORE a saved game, QUIT or UNDO the last command?

>eat cookie
Please give one of the answers above.

Would you like to RESTART, RESTORE a saved game, QUIT or UNDO the last command?

>undo
Backyard
[Previous turn undone.]

>eat cookie
You eat Cookie. Not bad.

>take frigge
You can't see any such thing.

>take fridge
You can't see any such thing.

>n
You can't go that way.

>s
Kitchen
You are super hungry! D: Let's eat something. If no one is in here, there might be people outside in the backyard north.

You can see Wooden door and Fridge (empty) here.

* * *

>e
Kitchen
You are super hungry! D: Let's eat something. If no one is in here, there might be people outside in the backyard north.

You can see Wooden door and Fridge (closed) here.

>n
(first opening Wooden door)
It seems to be locked.

>unlock door
(with key)
You unlock Wooden door.

>n
(first opening Wooden door)

Backyard
It is very chilly outside! We need to find people quick!You hear someone breathing, someone must be here! Let's find them!

You can see Wooden door, Tree and Shed (closed) here.

>take tree
That's fixed in place.

>s
Kitchen
You are super hungry! D: Let's eat something. If no one is in here, there might be people outside in the backyard north.

You can see Wooden door and Fridge (closed) here.

>open fridge
You open Fridge, revealing Cookie.

>take cookie
Taken.

>eat cookie
    *** OH GOD YOU DIED FROM THAT POISONOUS COOKIE! Oh no! That wasn't a very good cookie! :D ***

In that game you scored 0 out of a possible 3, in 9 turns.

Would you like to RESTART, RESTORE a saved game, QUIT or UNDO the last command?

>x me
Please give one of the answers above.

Would you like to RESTART, RESTORE a saved game, QUIT or UNDO the last command?

>undo
Kitchen
[Previous turn undone.]

>x me
 Your name is Allyshun Smurf and you smell really bad! No wonder why they are hiding from you!

* * *

>take cookie
Taken.

>eat cookie
That's plainly inedible.

* * *

>e
Kitchen
You are super hungry! D: Let's eat something. If no one is in here, there might be people outside in the backyard north.

You can see Wooden door and Fridge (closed) here.

>open door
You open Wooden door.

>s
Bedroom
You can see Bed here.

>undo
Kitchen
[Previous turn undone.]

>open door
You can't see any such thing.

* * *

>open door
You open Wooden door.

>n
Backyard
I hear someone breathing, someone must be here! Let's find them!

You can see Wooden door, Tree and Shed (closed) here.

Joe follows right behind you.

>open shed
You open Shed.

>take joe
I don't suppose Joe would care for that.

>s
Kitchen
There is a door going to the Backyard north.

You can see Wooden door here.

Joe follows right behind you.

* * *

>open door
You open Wooden door.

>look
Kitchen

* * *

>i
You are carrying:
  key

>s
Bathroom
This bathroon is kind of creepy! You don't think anyone is in the room. You see some footprints going east to the bedroom. Let's go check it out!

* * *

>e
Bedroom
This is your room, you know every place to hide in here! You wouldn't doubt if someone was in here.

You can see Bed, Rug and Desk here.

>bed
That's not a verb I recognise.

>look at bed
You see nothing special about Bed.

>look at rug
You see nothing special about Rug.

>desk
That's not a verb I recognise.

>xbed
That's not a verb I recognise.

>x bed
You see nothing special about Bed.

>x desk
You see nothing special about Desk.

>w
Bathroom
This bathroon is kind of creepy! You don't think anyone is in the room. You see some footprints going east to the bedroom. Let's go check it out!

* * *

>s
You can't go that way.

>e
Bedroom
This is your room, you know every place to hide in here! You wouldn't doubt if someone was in here.

You can see Bed, Rug and Desk here.

>w
Bathroom
This bathroon is kind of creepy! You don't think anyone is in the room. You see some footprints going east to the bedroom. Let's go check it out!

>n
Basement
It doesn't seem like anyone is hiding in the basement, so let's go somewhere else! There is the bathroom south, the living room west and the kitchen east of the basement

* * *

>take rebecca
[Your score has just gone up by one point.]

>x tv
You see nothing special about Tv.

>x couch\
You can't see any such thing.

>x couch
You see nothing special about Couch.

>w
You can't go that way.

* * *

>take cookie
Taken.

>open wooden door
It seems to be locked.

>unlock wooden door
What do you want to unlock Wooden door with?

>unlock wooden door with key
You unlock Wooden door.

>open wooden door
You open Wooden door.

>go n
Backyard
It is very chilly outside! We need to find people quick!You hear someone breathing, someone must be here! Let's find them!

You can see Wooden door, Tree and Shed (closed) here.

>s
Kitchen
You are super hungry! D: Let's eat something. If no one is in here, there might be people outside in the backyard north.

You can see Wooden door and Fridge (empty) here.

>w
Basement
It doesn't seem like anyone is hiding in the basement, so let's go somewhere else! There is the bathroom south, the living room west and the kitchen east of the basement

>e
Kitchen
You are super hungry! D: Let's eat something. If no one is in here, there might be people outside in the backyard north.

You can see Wooden door and Fridge (empty) here.

>n
Backyard
It is very chilly outside! We need to find people quick!You hear someone breathing, someone must be here! Let's find them!

You can see Wooden door, Tree and Shed (closed) here.

>open shed
You open Shed, revealing Joe.

>take joe
[Your score has just gone up by one point.]

>s
Kitchen
You are super hungry! D: Let's eat something. If no one is in here, there might be people outside in the backyard north.

You can see Wooden door and Fridge (empty) here.

>open wooden door
That's already open.

>w
Basement
It doesn't seem like anyone is hiding in the basement, so let's go somewhere else! There is the bathroom south, the living room west and the kitchen east of the basement

* * *

>e
Kitchen
You are super hungry! D: Let's eat something. If no one is in here, there might be people outside in the backyard north.

You can see Wooden door and Fridge (empty) here.

>s
Bedroom
This is your room, you know every place to hide in here! You wouldn't doubt if someone was in here.

You can see Bed, Rug and Desk here.

>n
Kitchen
You are super hungry! D: Let's eat something. If no one is in here, there might be people outside in the backyard north.

You can see Wooden door and Fridge (empty) here.

>s
Bedroom
This is your room, you know every place to hide in here! You wouldn't doubt if someone was in here.

You can see Bed, Rug and Desk here.

>bed
That's not a verb I recognise.

>tkae all
That's not a verb I recognise.

>take all
There are none at all available!

>s
You can't go that way.

>n
Kitchen
You are super hungry! D: Let's eat something. If no one is in here, there might be people outside in the backyard north.

You can see Wooden door and Fridge (empty) here.

>take all
There are none at all available!

>w
Basement
It doesn't seem like anyone is hiding in the basement, so let's go somewhere else! There is the bathroom south, the living room west and the kitchen east of the basement

>take all
There are none at all available!

>w
Living room
Something smells bad! Smells like body odor! EWWW! Someone has to be in here! 

You can see Tv, Couch, Lamp and Cabinet (empty) here.

>take all
There are none at all available!

>n
You can't go that way.

>e
Basement
It doesn't seem like anyone is hiding in the basement, so let's go somewhere else! There is the bathroom south, the living room west and the kitchen east of the basement

>e
Kitchen
You are super hungry! D: Let's eat something. If no one is in here, there might be people outside in the backyard north.

You can see Wooden door and Fridge (empty) here.

>take all
There are none at all available!

>n
Backyard
It is very chilly outside! We need to find people quick!You hear someone breathing, someone must be here! Let's find them!

You can see Wooden door, Tree and Shed (empty) here.

>take all
There are none at all available!

>i
You are carrying:
  Joe
  Cookie
  Rebecca
  key

>s
Kitchen
You are super hungry! D: Let's eat something. If no one is in here, there might be people outside in the backyard north.

You can see Wooden door and Fridge (empty) here.

>eat cookie
    *** OH GOD YOU DIED FROM THAT POISONOUS COOKIE! Oh no! That wasn't a very good cookie! :D ***

In that game you scored 2 out of a possible 3, in 51 turns.

Would you like to RESTART, RESTORE a saved game, QUIT or UNDO the last command?

>undo
Kitchen
[Previous turn undone.]

>w
Basement
It doesn't seem like anyone is hiding in the basement, so let's go somewhere else! There is the bathroom south, the living room west and the kitchen east of the basement

>s
Bathroom
This bathroon is kind of creepy! You don't think anyone is in the room. You see some footprints going east to the bedroom. Let's go check it out!

* * *

>e
Bedroom
This is your room, you know every place to hide in here! You wouldn't doubt if someone was in here.

You can see Bed, Rug and Desk here.

>look under bed
You find nothing of interest.

>look under rug
You find nothing of interest.

>look under desk
Oh my gosh! Blake was under the desk the whole time :o!

>take blake
    *** FINALLY! YOU FOUND EVERYONE! Maybe next time, you'll be hiding ;) ***

In that game you scored 3 out of a possible 3, in 57 turns.

Would you like to RESTART, RESTORE a saved game, QUIT or UNDO the last command?